.W.......
.Y.P.X.XW
.........
.X.....X.
.........
WX.X.X.X.
.......W.
4