.....W.......
.....X.X.X.YW
.............
.....X.......
.............
.....X.......
.............
.G.G.Y.P.....
...W.........
...Y.........
.............
5