.........
.....Y...
.....W...
.P.S.X.Y.
.....W...
...X.G...
.........
...X.....
.........
...Y.....
...W.....
5