.........
.....Y...
.........
...Y.GWY.
.........
...G.G.Y.
.........
.G.G.Y...
.........
5