.............
....WX.X.X.P.
.............
.....X.XW....
.............
.....X.X...Y.
.............
.......X.....
.............
.L.X.X.Y.Y.B.
.......W.....
.....X.......
.............
11