.........
...Y...S.
.........
.S.S.Y.X.
.........
...Y.....
.........
5