.....W.....
.....Y.....
...........
.....X.....
...........
.G.S.X.P.Y.
...........
...Y.......
...........
5