.........
.......G.
.........
...XWX.X.
...W.....
.X.X.....
.W.......
.YWX.....
.........
6