...........
.........P.
...........
.........X.
...........
WY.S.Y.P.X.
.........W.
...Y.......
...........
4