...........
.......P...
...........
.......X...
...........
WY.X.X.S...
...........
.......X.Y.
...........
4