...W.......
...X.Y.X.P.
...........
...X.......
...........
.G.P.Y.....
...........
...Y.......
...W.......
4