.............
.......P.X.YW
.............
.......Y.....
.............
.......X.....
.............
.P.X.Y.P.....
.............
3