...........
.....Y.....
...........
.Y.X.Y.X.L.
...........
.....G.....
...........
.Y.G.L.Y...
...........
.....G.....
...........
6