.........
.....G...
.........
.....G...
.....W...
.....S.Y.
.....W...
WY.X.P...
.....W...
.....Y.Y.
.........
5