.......W.
.......Y.
.........
.......X.
.........
...P...X.
.........
...X...X.
.........
.Y.X.G.XW
...W.....
4