.........
.G.......
.........
.X.......
.........
WX.X.P.YW
.........
.Y...L.Y.
.........
.H...X...
.........
.....Y...
.........
7