...............
.....Y.X.X.Y.L.
...............
.........X.....
...............
.L.Y.L.Y.X.X.L.
...............