...........
.H.........
...........
.X...Y.X.X.
.......W...
.L.Y.Y.X.X.
.......W...
.X...X.Y.L.
...........
.........P.
...........
9