.........
.X.X.L...
.........
.X.X.XWG.
.........
.X...X...
.........
.X...Y...
.........
.X...Y...
.........
.P...Y...
.....W...