.........
.YWX.X.G.
.........
...X.X...
.........
.Y.L.X...
.........
