...........
.....P.....
...........
.....P.....
...........
.....X.X.L.
...........
.....Y.....
...........
...YWXWG...
...........
.....Y.....
...........
.Y.X.X.....
...........