.......W...
.P..WX.X.YW
...........
.P...Y.X...
...........
.P.Y.X.XW..
.W.........
9