.W.......
.Y.......
.........
.X...Y...
.........
.X.YWXWX.
.........
WX.X.S.P.
.........
.......G.
.........
6