...........
.....L.X.L.
...........
.X.X.X...L.
...W.......
.Y.Y.X...X.
.....W.....
.X.X.X.X.X.
...........
.....X.....
...........
.....Y.....
...........
11