...........
...X.X.X...
...........
.X.X.X.X.X.
...........
.X.Y...L.X.
...........
.L.......Y.
...........
7