.W...........
.X...........
.............
WX.X.X.L.....
.............
.Y.....LWX.X.
.............
.......X.X.X.
.............
.......X.Y.X.
.............
9