...........
...Y.......
...........
...........
...........
...X.X...X.
...........
WY.X.X.X.P.
...........
...........
...........
...S.B.Y.H.
...........
.....Y.....
...........
8