...........
.....Y.....
...........
.P.X.X.X.X.
...........
.X.......Y.
.....W.....
.X.YWHW..X.
.....W.....
.Y.......X.
...........
.X.X.X.X.P.
...........
.....B.....
...........
12