.............
.........Y...
.............
.....X.X.SWX.
.............
.....X.....Y.
.............
.Y.YWHWG...L.
.............
8