...............
.......P.......
...............
.......Y.......
...............
.......Y.......
...............
.P.X.Y.Y.Y.L.G.
...............
.......Y.......
...............
.......H.......
...............
.......B.......
...............
7