...........
.....X...Y.
...........
...........
...........
.....X.....
...........
.Y...X...H.
...........
.H...X.....
...........