...........
.......Y...
...W.......
.YWX.XWS.G.
...........
...XWX.....
...........
...PWX.....
...........
.....Y.....
.....W.....
6