.........
...X.X.X.
.........
...X...X.
.........
...Y...L.
.........
...Y.....
.........
.YWXWG...
.........
...P.....
.........