...............
.....B.........
...............
.....X.........
...........W.W.
.....X.....Y.Y.
...............
.P.P.P.X.Y.X.XW
...............
.....X.....X.Y.
...........W...
8