...........
.....Y.....
.....W.....
.....X.....
...........
WY.X.Y.G.G.
...........
.....X.....
...........
.....P.....
...........
6