.W...........
.Y...........
.........W...
WY.P.X.X.X.XW
...W.........
WP.Y.X.X.X.X.
.............
.........Y.X.
.............
.........P.P.
.............
8