...........
.....Y.....
...........
.Y.B.X...X.
...........
.Y.S.X...Y.
...........
...Y.L...P.
...........
...........
...........
.........H.
...........
10