.............
.X.B.L.......
.....W.......
.X...L...Y...
.............
.Y...L...X...
.............
.GWX.Y.X.X.Y.
.............
.....Y.......
.............
9