.........
....WX.P.
.........
.YWX.XWG.
.........
WY.X.X...
.........
.Y.L.X...
.........