.........
...X.....
.........
...Y.....
.........
...X.X.L.
.........
.XWP.HWY.
.........
.Y.X.XW..
.........