...........
.Y.........
...........
.X...X.X.L.
...........
.H...Y.Y.X.
...........
.....Y.X.L.
...........
.........P.
...........
9